//MAP CONVERTED BY dmm2tgm.py THIS HEADER COMMENT PREVENTS RECONVERSION, DO NOT REMOVE
"a" = (
/turf/closed/wall/r_wall,
/area/station/command/heads_quarters/nt_rep)
"b" = (
/obj/structure/chair/comfy/black{
	dir = 4
	},
/obj/effect/landmark/start/nanotrasen_consultant,
/turf/open/floor/carpet/executive,
/area/station/command/heads_quarters/nt_rep)
"c" = (
/obj/effect/spawner/structure/window/reinforced,
/obj/structure/curtain/cloth/fancy/mechanical{
	id = "NTRshutter"
	},
/obj/machinery/door/firedoor,
/turf/open/floor/plating,
/area/station/command/heads_quarters/nt_rep)
"d" = (
/obj/structure/chair/comfy/brown{
	dir = 1
	},
/obj/machinery/atmospherics/pipe/smart/manifold4w/scrubbers/hidden/layer2,
/obj/effect/landmark/start/hangover,
/turf/open/floor/wood,
/area/station/command/heads_quarters/nt_rep)
"e" = (
/obj/item/kirbyplants/random,
/turf/open/floor/wood,
/area/station/command/heads_quarters/nt_rep)
"f" = (
/obj/machinery/power/apc/auto_name/directional/north,
/obj/structure/cable,
/turf/open/floor/wood,
/area/station/command/heads_quarters/nt_rep)
"g" = (
/obj/structure/bookcase/manuals/research_and_development,
/turf/open/floor/wood,
/area/station/command/heads_quarters/nt_rep)
"h" = (
/obj/structure/bookcase/random/nonfiction,
/turf/open/floor/wood,
/area/station/command/heads_quarters/nt_rep)
"h" = (
/obj/machinery/light/directional/west,
/turf/template_noop,
/area/template_noop)
"i" = (
/turf/template_noop,
/area/template_noop)
"j" = (
/obj/structure/cable,
/obj/effect/decal/cleanable/dirt,
/turf/open/floor/wood,
/area/station/command/heads_quarters/nt_rep)
"k" = (
/obj/structure/table/wood,
/obj/item/cigbutt/cigarbutt{
	pixel_x = 7
	},
/obj/item/phone{
	desc = "Supposedly a direct line to Nanotrasen Central Command. It's not even plugged in.";
	pixel_x = -3;
	pixel_y = 3
	},
/obj/effect/landmark/start/hangover,
/turf/open/floor/wood,
/area/station/command/heads_quarters/nt_rep)
"m" = (
/obj/machinery/newscaster/directional/north,
/obj/machinery/modular_computer/preset/command,
/turf/open/floor/carpet/executive,
/area/station/command/heads_quarters/nt_rep)
"n" = (
/obj/machinery/holopad,
/turf/open/floor/wood,
/area/station/command/heads_quarters/nt_rep)
"o" = (
/obj/machinery/disposal/bin,
/obj/structure/disposalpipe/trunk{
	dir = 4
	},
/turf/open/floor/wood,
/area/station/command/heads_quarters/nt_rep)
"p" = (
/obj/structure/sign/directions/arrival{
	dir = 1;
	pixel_y = 10
	},
/obj/structure/sign/directions/science{
	pixel_y = 2
	},
/obj/structure/sign/directions/engineering{
	pixel_y = -6
	},
/turf/closed/wall/r_wall,
/area/station/command/heads_quarters/nt_rep)
"q" = (
/obj/structure/extinguisher_cabinet/directional/south,
/obj/effect/decal/cleanable/dirt,
/obj/effect/landmark/start/hangover,
/turf/open/floor/carpet/executive,
/area/station/command/heads_quarters/nt_rep)
"s" = (
/obj/machinery/atmospherics/pipe/smart/manifold4w/supply/hidden/layer4,
/obj/machinery/door/airlock/maintenance_hatch{
	name = "Maintenance Hatch"
	},
/obj/effect/turf_decal/stripes/line{
	dir = 1
	},
/obj/effect/turf_decal/stripes/line,
/obj/effect/mapping_helpers/airlock/unres{
	dir = 1
	},
/obj/effect/mapping_helpers/airlock/access/any/engineering/maintenance/departmental,
/obj/structure/cable,
/turf/open/floor/iron,
/area/station/maintenance/port/fore)
"t" = (
/obj/structure/table/wood,
/obj/machinery/fax{
	fax_name = "Law Office";
	name = "Council Office Fax Machine";
	pixel_y = 4
	},
/obj/machinery/button/curtain{
	pixel_y = 26;
	id = "NTRshutter"
	},
/obj/machinery/firealarm/directional/west,
/turf/open/floor/carpet/executive,
/area/station/command/heads_quarters/nt_rep)
"u" = (
/obj/machinery/vending/cigarette,
/turf/open/floor/wood,
/area/station/command/heads_quarters/nt_rep)
"v" = (
/obj/structure/table/wood,
/obj/item/paper_bin,
/obj/item/pen,
/obj/item/radio/intercom/directional/west,
/obj/item/stamp/centcom{
	pixel_y = 8
	},
/obj/item/stamp{
	pixel_x = -6
	},
/obj/item/stamp/denied{
	pixel_x = 6
	},
/turf/open/floor/carpet/executive,
/area/station/command/heads_quarters/nt_rep)
"w" = (
/obj/effect/spawner/structure/window/reinforced,
/obj/structure/disposalpipe/segment{
	dir = 4
	},
/obj/structure/curtain/cloth/fancy/mechanical{
	id = "NTRshutter"
	},
/obj/machinery/door/firedoor,
/turf/open/floor/plating,
/area/station/command/heads_quarters/nt_rep)
"x" = (
/obj/machinery/photocopier,
/obj/structure/sign/poster/official/here_for_your_safety/directional/south,
/turf/open/floor/wood,
/area/station/command/heads_quarters/nt_rep)
"y" = (
/obj/effect/decal/cleanable/dirt,
/turf/open/floor/wood,
/area/station/command/heads_quarters/nt_rep)
"z" = (
/obj/machinery/airalarm/directional/north,
/obj/machinery/camera/directional/north{
	c_tag = "Bridge - Hall";
	name = "command camera"
	},
/obj/effect/decal/cleanable/dirt,
/mob/living/basic/mouse/white{
	name = "The Destroyer of Worlds";
	desc = "Destroyed 13 solar systems, 15 galaxies and one piece of cheese"
	},
/turf/open/floor/wood,
/area/station/command/heads_quarters/nt_rep)
"B" = (
/obj/machinery/atmospherics/pipe/smart/manifold4w/supply/hidden/layer4,
/obj/machinery/atmospherics/pipe/smart/manifold4w/scrubbers/hidden/layer2,
/obj/effect/decal/cleanable/dirt,
/turf/open/floor/wood,
/area/station/command/heads_quarters/nt_rep)
"C" = (
/obj/effect/turf_decal/siding/wood{
	dir = 8
	},
/obj/effect/decal/cleanable/dirt,
/obj/effect/landmark/start/hangover,
/turf/open/floor/wood,
/area/station/command/heads_quarters/nt_rep)
"D" = (
/obj/structure/chair/comfy/brown,
/obj/structure/sign/flag/nanotrasen/directional/north,
/turf/open/floor/wood,
/area/station/command/heads_quarters/nt_rep)
"E" = (
/obj/structure/closet/secure_closet/nanotrasen_consultant/station,
/obj/item/storage/briefcase,
/obj/item/assembly/flash/handheld,
/obj/effect/turf_decal/tile/neutral/fourcorners,
/obj/item/camera_film{
	pixel_x = 6;
	pixel_y = 4
	},
/obj/item/camera_film{
	pixel_x = 6;
	pixel_y = 4
	},
/obj/item/camera{
	pixel_x = -6;
	pixel_y = 7
	},
/turf/open/floor/wood,
/area/station/command/heads_quarters/nt_rep)
"F" = (
/obj/effect/turf_decal/siding/wood{
	dir = 8
	},
/obj/machinery/atmospherics/pipe/smart/manifold4w/scrubbers/hidden/layer2,
/turf/open/floor/wood,
/area/station/command/heads_quarters/nt_rep)
"H" = (
/obj/structure/chair/comfy/brown{
	dir = 1
	},
/obj/machinery/atmospherics/pipe/smart/manifold4w/supply/hidden/layer4,
/obj/machinery/atmospherics/pipe/smart/manifold4w/scrubbers/hidden/layer2,
/obj/effect/landmark/start/hangover,
/turf/open/floor/wood,
/area/station/command/heads_quarters/nt_rep)
"H" = (
/obj/structure/disposalpipe/junction/yjunction{
	dir = 1
	},
/turf/open/floor/iron,
/area/station/hallway/primary/central/fore)
"I" = (
/obj/structure/table/wood,
/obj/item/clipboard{
	pixel_y = 1
	},
/obj/item/storage/fancy/cigarettes/cigars/havana,
/obj/machinery/atmospherics/components/unary/vent_pump/on/layer4,
/turf/open/floor/wood,
/area/station/command/heads_quarters/nt_rep)
"J" = (
/obj/structure/sign/nanotrasen{
	pixel_y = -32
	},
/obj/effect/landmark/start/hangover,
/turf/open/floor/carpet/executive,
/area/station/command/heads_quarters/nt_rep)
"K" = (
/obj/machinery/atmospherics/pipe/smart/manifold4w/supply/hidden/layer4,
/obj/machinery/atmospherics/pipe/smart/manifold4w/scrubbers/hidden/layer2,
/obj/structure/cable,
/obj/effect/landmark/start/hangover,
/turf/open/floor/wood,
/area/station/command/heads_quarters/nt_rep)
"L" = (
/obj/machinery/atmospherics/pipe/smart/manifold4w/supply/hidden/layer4,
/obj/machinery/atmospherics/pipe/smart/manifold4w/scrubbers/hidden/layer2,
/obj/structure/cable,
/obj/machinery/door/firedoor,
/obj/effect/mapping_helpers/airlock/access/all/cent_com/rep_door,
/obj/machinery/door/airlock/corporate{
	name = "Representative's Office"
	},
/turf/open/floor/wood,
/area/station/command/heads_quarters/nt_rep)
"M" = (
/obj/structure/table/wood,
/obj/machinery/recharger{
	pixel_y = 4;
	pixel_x = -7
	},
/obj/item/book/manual/wiki/security_space_law{
	pixel_y = 13;
	pixel_x = 6
	},
/obj/machinery/light/directional/west,
/obj/item/reagent_containers/cup/glass/mug/nanotrasen{
	pixel_x = 7
	},
/turf/open/floor/carpet/executive,
/area/station/command/heads_quarters/nt_rep)
"P" = (
/obj/effect/turf_decal/siding/wood{
	dir = 8
	},
/obj/machinery/status_display/evac/directional/south,
/obj/effect/landmark/start/hangover,
/turf/open/floor/wood,
/area/station/command/heads_quarters/nt_rep)
"Q" = (
/obj/structure/cable,
/turf/open/floor/wood,
/area/station/command/heads_quarters/nt_rep)
"R" = (
/obj/structure/table/wood,
/obj/item/book/manual/wiki/security_space_law{
	pixel_y = 14
	},
/obj/item/folder/yellow{
	pixel_x = 3;
	pixel_y = 6
	},
/obj/item/folder/red{
	pixel_x = 1;
	pixel_y = 3
	},
/obj/item/folder/blue,
/turf/open/floor/carpet/executive,
/area/station/command/heads_quarters/nt_rep)
"S" = (
/obj/machinery/light/directional/south,
/obj/structure/filingcabinet/security{
	pixel_x = 10
	},
/obj/structure/filingcabinet/medical,
/obj/structure/filingcabinet/employment{
	pixel_x = -11
	},
/turf/open/floor/wood,
/area/station/command/heads_quarters/nt_rep)
"U" = (
/obj/structure/chair/comfy/brown,
/obj/machinery/light/directional/north,
/obj/structure/sign/clock/directional/north,
/obj/effect/decal/cleanable/dirt,
/turf/open/floor/wood,
/area/station/command/heads_quarters/nt_rep)
"V" = (
/obj/effect/turf_decal/siding/wood/corner{
	dir = 8
	},
/obj/effect/decal/cleanable/dirt,
/obj/effect/landmark/start/hangover,
/turf/open/floor/wood,
/area/station/command/heads_quarters/nt_rep)
"W" = (
/obj/machinery/atmospherics/pipe/smart/manifold4w/supply/hidden/layer4,
/obj/machinery/atmospherics/pipe/smart/manifold4w/scrubbers/hidden/layer2,
/obj/structure/cable,
/obj/effect/decal/cleanable/dirt,
/turf/open/floor/wood,
/area/station/command/heads_quarters/nt_rep)
"Y" = (
/obj/structure/table/wood,
/obj/item/camera,
/obj/item/flashlight/lamp/green{
	pixel_y = 16
	},
/obj/machinery/atmospherics/components/unary/vent_scrubber/on/layer2{
	dir = 4
	},
/turf/open/floor/carpet/executive,
/area/station/command/heads_quarters/nt_rep)

(1,1,1) = {"
i
i
a
a
a
a
a
"}
(2,1,1) = {"
i
i
a
t
v
M
a
"}
(3,1,1) = {"
a
a
a
m
b
J
a
"}
(4,1,1) = {"
a
u
E
Y
R
q
a
"}
(5,1,1) = {"
a
z
V
F
C
P
a
"}
(6,1,1) = {"
a
D
k
d
n
y
s
"}
(7,1,1) = {"
a
U
I
H
B
S
a
"}
(8,1,1) = {"
a
f
Q
j
W
x
a
"}
(9,1,1) = {"
a
h
g
e
K
o
a
"}
(10,1,1) = {"
a
a
p
c
L
w
a
"}
(11,1,1) = {"
i
i
i
i
H
i
h
"}
